X X X X X X X X X X X
X W W W X F X W W W X
X W W W W L W W W W X
X W W W W W W W S W X
X K W W W W W W W S X
X W W W E E P W W W X
X W W W E G E W W W X
X W W W W E W W W W X
X W S W W W W W W W X
X W W W W W W W W W X
X X X X X X X X X X X