X X X X X X X X X X X
X E W W E E B W B E X
X E B B E B E W B E X
X K W W E E E W E E X
X B W W W E W W W S X
X F W W W P S W W W X
X B W S W W W W W F X
X W W W E L E W S W X
X W W E B B B E W W X
X E E E E E E E E E X
X X X X X X X X X X X