X X X X X X X X X X X
X F W W W W W W E P X
X W W W S W W E E E X
X W W S W W E E E E X
X W S W W E E E E E X
X W W W E E E E E E X
X W W E E E E E E E X
X B E B E B E B E B X
X E B E B E B E B E X
X E E E E E E E E E X
X X X X X X X X X X X